11111111111111111111
10000000000000000001
10000000000000000001
10000000000000000001
10000000000000000001
10001111111110000001
10000000000000000001
10000000000000000001
10000000000000000001
10000000000012221111
10000000000010000001
10030000000010000001
10000000000010000001
11111111111111111111
