11111111111111111111
10000000000000000001
10000000000000000001
10002220000000000001
10002020000000000001
10002220010000000001
10000000010000000001
10000000011110000001
10000000010000000001
10000000010000000001
10000000000000000001
10000000000000000001
10000000000000000001
11111111111111111111
