11111111111111111111
10001000000000000001
10001000000000000001
10001000000000000001
10000000000000000001
10000000001111111001
10000000000000000001
10000000000000000001
10000000000003000001
11100100000003000001
10000100000003000001
10000100000000000001
10000100000000000001
11111111111111111111
