11111111111111111111
10000000010000000001
10000000010000000001
10033330010000000001
10030030011111000001
10033330010000000001
10000000010000000001
11000111110000000001
10000000020000000001
10000000020000000001
10000000010000011111
10000000000000000001
10000000000000000001
11111111111111111111
